11111111111111111111111111111111111111111
10000000000000000000000000000000000000001
10000000000000000100000000000000000000001
10000000000000000C00000000000000000000001
100000000000000000E0000000000000000000001
10000000010000C00P000C1000000000000000001
10000000010000000C00000000000000000000001
10000000010000000100000000000000000000001
10000000010000000000000000000000000000001
10000000010000000000000000000000000000001
10000000010000000000000000000000000000001
10000000010000000000000000000000000000001
10000000000000000000000000000000000000001
10000000000000000000000000000000000000001
10000000000000000000000000000000000000001
10000000000000000000000000000000000000001
10000000000000000000000000000000000000001
10000000000000000000000000000000000000001
10000000000000000000000000000000000000001
10000000000000000000000000000000000000001
11111111111111111111111111111111111111111
