1111111111111
1CP00000000C1
1001010111001
1001C100C1001
1001110111001
10000101C0001
1000010111001
1C0000E000001
1111111111111
