1111111111111111111111111111111111111111
1000000000000000000000000000000000000001
1000000000000000010000000000000000000001
10000000000000000C0000000000000000000001
100000000000000000E000000000000000000001
10000000010000C00P000C100000000000000001
10000000010000000C0000000000000000000001
1000000001000000010000000000000000000001
1000000001000000000000000000000000000001
1000000001000000000000000000000000000001
1000000001000000000000000000000000000001
1000000001000000000000000000000000000001
1000000000000000000000000000000000000001
1000000000000000000000000000000000000001
1000000000000000000000000000000000000001
1000000000000000000000000000000000000001
1000000000000000000000000000000000000001
1000000000000000000000000000000000000001
1000000000000000000000000000000000000001
1000000000000000000000000000000000000001
1000000000000000000000000000000000000001
1111111111111111111111111111111111111111
