1111111111111111111111111111111111111111
1000000000000000000000000000000000000001
1000000000000000010000000000000000000001
1000000000000000000000000000000000000001
1000000000000001000000000000000000000001
10000000010000C10P000C100000000000000001
1000000001000001000100000000000000000001
1000000001000000101100000000000000000001
1000000001000000000000000000000000000001
1000000001000000000000000000000000000001
1000000001000000000000000000000000000001
1000000001000000000000000000111111111111
1000000000000000000000000001111111111111
1000000000000CCC000000000001000000000001
1000000000000CEC000000000001011111111111
1000000000000CCC000000000001000000000001
1000000000000000000000000001111111111101
1000000000000000000000000001000000000001
1000000000000000000000000001011111111111
1000000000000000000000000000000000000001
1111111111111111111111111111111111111111
